// example map
{
    "cities": [
        "A",
        "B",
        "C",
        "D",
        "E",
        "F",
        "G",
    ],
    "connections": [
        [ "A", "C", 3, ],
        [ "A", "F", 2, ],
        [ "C", "F", 2, ],
        [ "C", "E", 1, ],
        [ "C", "D", 4, ],
        [ "F", "E", 3, ],
        [ "F", "B", 6, ],
        [ "F", "G", 5, ],
        [ "E", "B", 2, ],
        [ "D", "B", 1, ],
        [ "G", "B", 2, ],
    ],
}
